+--+--+--+--+--+--+--+--+--+--+
                              |
+--+--+  +--+--+  +  +--+  +  +
|     |  |  |     |  |     |  |
+  +  +  +  +  +--+--+  +--+  +
|  |  |  |  |        |     |  |
+  +--+  +  +--+--+  +  +  +  +
|           |     |     |
+--+--+--+--+--+--+--+--+--+--+
